*****************************
***          5     *        *
*                  *   3    *
*                  *        *
*                           *
*                           *
********           **********
*      *                    *
*  2   *                    *
*                         v *
*****************************